R, R, R, R, R,
R, C-a, C, C, R,
R, C, R, M, R,
R, R, R, C, R,
R, C, C, C, R,
R, C, C, C, R,
R, R, R, R, R,
