C, C, C, C, C, C, C, C, C, C, C, C, C, R, C,
C, R, R, R, C, R, R, R, C, C, R, C, C, C, C,
C, C-a, C, C, C, R, R, R, R, C, C, R, M, C, C,
C, R, C, C, C, R, C, C, C, C, C, R, R, C, R,
C, C, R, C, C, R, C, R, R, C, R, R, C, C, R,
C, C, C-b, C, C, C, C, C, C, C, C, C, C, C, R,
C, C, C, C, C, C, C, C, C, C, C, C, C, C, C,

